20
15
20 16 16 16 16 16 16 16 16 16 16 16 16 16 16 16 16 16 16 21 
17 0 0 0 0 0 0 0 0 0 0 0 0 0 0 0 0 0 0 17 
17 0 0 0 0 0 0 0 0 0 0 0 0 0 0 0 0 0 0 17 
17 0 4 0 0 0 0 0 0 0 0 0 0 0 0 0 0 0 0 17 
23 16 16 27 31 0 0 31 31 31 16 16 16 16 16 16 27 0 0 17 
17 0 0 0 0 0 0 0 0 17 0 0 0 0 0 31 0 0 0 17 
17 0 0 0 0 0 0 0 0 17 0 0 0 0 0 0 0 0 28 17 
17 0 0 0 0 0 0 0 0 17 0 0 0 0 0 0 0 0 0 17 
17 0 0 0 0 0 0 0 0 30 0 0 0 0 0 0 0 0 0 17 
17 0 0 0 0 0 31 0 0 0 0 0 0 29 0 0 0 0 28 24 
17 0 0 0 0 0 29 0 0 0 0 0 0 17 0 0 0 0 0 17 
23 26 26 21 0 0 30 0 0 0 0 0 0 17 0 0 0 0 0 17 
23 22 22 24 0 0 0 0 0 0 0 20 26 22 26 26 26 26 26 24 
23 22 22 24 31 31 31 31 31 31 31 23 22 22 22 22 22 22 22 24 
18 25 25 25 16 16 16 16 16 16 16 25 25 25 25 25 25 25 25 19 
