20
15
20 26 26 26 26 16 16 16 16 16 16 16 16 26 16 16 16 16 16 21 
23 22 22 22 24 0 0 0 0 0 0 0 0 17 0 0 0 0 0 17 
23 22 22 22 24 0 0 0 0 0 0 0 0 17 0 0 0 0 0 17 
23 22 22 22 24 0 0 0 0 31 29 0 0 17 0 0 29 0 0 17 
23 25 25 25 25 27 31 0 0 0 23 27 0 17 0 0 17 0 4 17 
17 0 0 0 0 0 0 0 0 0 17 0 0 23 21 0 18 16 16 24 
17 0 0 0 0 0 0 0 0 0 17 0 0 23 24 0 0 0 0 17 
17 0 0 0 0 0 0 0 0 0 23 27 0 23 24 0 0 0 0 17 
17 0 0 0 0 0 31 31 31 31 17 0 0 23 25 16 16 31 0 17 
23 26 26 26 26 26 16 16 31 16 19 0 0 17 0 0 0 0 0 17 
23 22 22 22 22 24 0 0 0 0 0 0 28 24 0 0 0 0 0 17 
23 22 22 22 22 24 0 0 0 0 0 0 0 17 0 0 31 28 16 24 
23 22 22 22 22 24 0 28 31 16 16 16 16 19 0 0 0 0 0 17 
23 22 22 22 22 24 0 0 0 0 0 0 0 0 0 0 0 0 0 17 
18 25 25 25 25 25 16 27 0 0 28 16 16 16 16 31 31 31 31 19 
