20
15
20 16 16 16 16 16 16 16 16 16 16 16 16 16 16 16 16 26 26 21 
17 0 0 0 0 0 0 0 0 0 0 0 0 0 0 0 0 23 22 24 
17 0 0 20 16 16 16 16 21 0 0 0 0 0 0 0 0 23 22 24 
17 0 0 30 31 31 31 31 18 16 16 16 21 0 0 0 0 23 22 24 
17 0 0 0 0 0 0 0 0 0 0 0 17 31 31 0 0 23 22 24 
17 0 0 0 0 0 0 0 0 0 0 0 17 0 0 0 0 23 22 24 
23 21 0 0 0 0 0 0 0 0 0 0 17 0 0 0 0 23 22 24 
23 22 21 0 0 0 29 0 0 0 0 0 17 0 0 0 0 23 22 24 
23 22 24 31 31 31 17 0 0 0 0 0 17 0 31 0 0 23 22 24 
23 25 25 16 16 16 25 16 27 0 0 0 17 0 28 16 16 22 22 24 
17 0 0 0 0 0 0 0 0 0 0 0 17 0 0 0 0 23 22 24 
17 0 0 0 0 0 0 0 0 0 0 0 17 0 0 0 0 18 25 24 
17 0 0 0 0 0 0 0 31 0 0 0 17 0 0 0 0 0 0 17 
17 0 0 0 0 0 0 0 29 31 31 31 17 0 0 0 0 0 4 17 
18 16 16 16 16 16 16 16 25 16 16 16 25 31 28 16 16 16 16 19 
