20
15
5 5 5 5 5 5 5 5 5 5 5 5 5 5 5 5 5 5 5 5 
5 0 0 0 0 0 0 0 0 0 0 0 0 0 0 0 0 0 8 5 
5 0 0 0 0 0 0 0 0 0 0 0 0 0 0 0 0 0 8 5 
5 0 4 0 0 0 0 0 0 8 0 0 8 0 0 0 0 0 8 5 
5 5 5 5 5 5 5 5 5 5 5 5 5 5 5 5 5 0 5 5 
5 0 0 0 0 0 0 0 0 5 5 0 0 0 0 0 5 0 5 5 
5 0 0 0 0 0 0 0 0 5 5 0 0 0 0 0 0 0 0 5 
5 0 0 0 0 0 0 0 0 5 5 0 0 0 0 0 0 0 0 5 
5 0 0 0 5 5 8 0 8 5 5 0 0 0 8 5 5 5 5 5 
5 0 0 0 8 5 0 0 0 5 5 0 0 0 8 5 6 6 6 6 
5 0 0 0 8 5 0 0 0 5 5 0 0 0 8 5 6 6 6 6 
8 0 0 0 5 5 0 0 0 0 0 0 0 0 8 5 6 6 6 6 
8 0 0 0 5 5 0 0 0 0 0 0 0 0 5 5 6 6 6 6 
5 0 0 0 5 5 0 0 0 8 8 0 0 0 5 6 6 6 6 6 
5 5 5 5 5 5 5 5 5 5 5 5 5 5 5 6 6 6 6 6 
