38
27
41 34 34 34 34 34 43 43 43 43 43 34 42 34 34 34 34 34 34 34 34 34 34 34 34 34 34 34 34 34 34 42 34 34 34 34 34 34 
41 42 44 43 44 45 0 0 0 0 0 24 44 43 44 43 44 44 44 44 43 43 44 44 44 43 44 43 44 43 43 43 44 44 44 44 44 34 
41 35 0 0 0 0 0 0 0 0 0 0 0 0 0 0 0 0 0 0 0 0 0 0 0 0 0 0 0 0 0 0 0 0 0 0 0 41 
41 35 0 0 0 0 0 0 0 0 0 0 0 0 0 0 0 0 0 0 0 0 0 0 0 0 0 0 0 0 0 0 0 0 0 0 0 41 
41 35 0 0 27 27 0 0 0 0 36 28 28 28 28 0 0 0 21 0 0 0 0 0 0 0 0 0 0 0 0 0 0 0 0 0 0 41 
41 35 0 0 0 0 0 0 0 0 0 0 0 0 0 0 0 0 29 31 30 30 31 31 31 31 31 30 31 31 31 31 31 30 30 31 31 34 
41 35 0 0 0 27 0 0 0 0 0 0 0 0 0 0 0 0 41 42 34 34 34 34 34 34 34 34 34 34 34 34 34 42 34 34 34 34 
41 35 0 0 0 27 0 0 0 0 0 0 0 0 0 0 0 0 24 43 43 44 43 43 43 43 43 44 44 43 43 43 43 44 44 34 34 34 
41 35 0 0 0 27 0 0 0 0 0 0 0 0 0 0 0 0 0 0 0 0 0 0 0 0 0 0 0 0 0 0 0 0 0 41 34 34 
41 35 0 0 0 0 0 0 25 0 0 0 0 0 0 0 0 0 0 0 0 0 0 0 0 0 0 0 0 0 0 0 0 0 0 41 34 34 
41 35 0 0 0 0 0 0 0 0 0 0 0 0 0 0 0 0 0 0 0 0 0 0 0 0 0 0 0 0 0 0 0 0 0 41 42 34 
41 35 0 0 0 0 0 0 0 0 0 29 30 31 30 32 0 0 0 0 0 0 0 20 0 0 0 0 0 0 0 0 0 0 0 41 34 34 
41 35 2 3 3 3 2 2 2 3 2 41 34 34 34 35 0 0 0 0 0 0 0 0 0 0 29 30 31 32 0 0 0 0 0 41 34 34 
41 34 31 30 31 31 31 31 30 30 31 34 34 42 34 35 0 0 0 0 0 0 0 0 0 0 41 42 34 35 0 0 0 0 0 41 34 34 
41 34 34 34 34 34 34 34 34 34 34 34 34 34 34 34 31 30 31 30 30 31 30 30 31 31 34 34 34 35 0 0 0 0 0 41 34 34 
41 34 34 34 34 34 34 34 34 34 34 34 34 34 34 34 34 34 34 34 42 34 34 34 34 34 34 34 34 34 30 32 0 0 0 41 34 42 
41 34 42 34 34 34 34 34 34 34 34 34 34 34 43 43 43 44 43 43 43 43 44 44 43 43 44 43 43 43 44 45 0 0 0 41 34 34 
41 34 34 34 34 34 34 34 42 34 34 34 34 35 0 0 0 0 0 0 0 0 0 0 0 0 0 0 0 0 0 0 0 0 0 24 44 34 
41 34 34 34 34 34 34 34 34 34 34 34 34 35 0 0 0 0 0 0 0 0 0 0 0 0 0 0 0 0 0 0 0 0 0 0 0 41 
41 34 34 34 34 34 43 43 44 44 43 43 44 45 0 0 0 0 0 0 0 0 0 0 0 0 0 0 0 0 0 0 0 0 0 0 0 41 
41 34 44 44 43 45 0 0 0 0 0 0 0 0 0 0 0 0 0 0 17 0 29 31 32 0 0 0 0 0 0 0 0 0 0 0 0 41 
41 35 0 0 0 0 0 0 0 0 0 0 0 0 0 0 0 0 0 0 0 0 41 34 35 0 0 0 0 0 0 36 36 36 0 0 17 41 
41 35 0 0 0 0 0 0 0 0 0 0 0 0 0 0 0 0 0 0 0 0 41 42 35 0 0 0 0 0 0 0 0 0 0 0 17 41 
41 35 0 0 15 16 0 0 0 0 0 0 0 0 0 0 0 0 0 29 30 30 34 34 35 0 0 0 0 0 0 0 0 0 0 0 0 41 
41 35 0 0 0 0 0 0 0 0 0 0 0 0 0 0 0 0 0 41 34 34 34 34 35 21 21 21 0 0 0 0 0 0 0 0 0 41 
41 34 31 31 30 31 31 31 30 30 31 31 30 31 31 31 30 31 31 34 34 42 34 34 42 31 31 30 31 31 31 30 30 30 31 31 30 34 
24 43 43 43 43 43 43 43 43 43 43 43 43 43 43 43 43 43 43 43 43 43 43 43 43 43 43 43 43 43 43 43 43 43 43 43 43 45 
