80
15
0 0 0 0 0 28 16 16 16 16 16 16 16 16 16 16 16 16 16 16 16 16 16 26 26 16 16 16 16 16 16 16 16 16 16 16 26 26 26 26 26 26 26 26 26 26 26 26 26 16 16 16 16 26 16 16 16 16 16 16 26 26 16 16 16 16 16 16 16 16 16 16 26 16 16 16 16 16 16 21 
0 0 0 0 0 0 0 0 0 0 0 0 0 0 0 0 0 0 0 0 0 0 0 23 24 0 0 0 0 0 0 0 0 0 0 0 23 22 22 22 22 22 22 22 22 22 22 22 24 0 0 0 0 17 0 0 0 0 0 0 23 24 0 0 0 31 31 31 31 31 31 31 17 0 0 0 0 0 0 17 
0 0 0 0 0 0 0 0 0 0 0 0 0 0 0 0 0 0 0 0 0 0 0 23 24 0 0 0 0 0 0 0 0 0 0 0 23 22 22 22 22 22 22 22 22 22 22 22 24 0 0 0 0 17 0 0 0 0 0 0 23 24 0 0 0 31 31 31 31 31 31 31 17 0 0 0 0 0 0 17 
0 0 0 0 0 0 0 0 0 0 0 0 0 0 0 0 0 0 0 0 0 0 0 23 24 0 0 0 31 0 0 0 0 0 0 0 23 22 22 22 22 22 25 25 25 25 25 25 19 0 0 0 0 17 0 0 0 0 0 0 23 24 0 0 0 31 31 31 31 31 31 31 30 0 0 0 0 0 0 17 
0 0 0 0 0 0 0 0 0 0 0 0 0 0 0 0 0 0 0 0 0 0 0 23 24 0 28 16 16 26 26 21 0 0 0 0 23 22 22 22 22 24 31 31 31 31 31 31 31 0 0 0 0 17 0 0 0 0 0 0 23 24 0 0 0 0 0 0 0 0 0 0 0 0 0 0 0 0 0 17 
0 0 0 0 0 0 0 0 0 0 0 0 0 0 0 0 0 0 0 0 0 0 0 23 24 0 0 0 0 23 22 24 31 31 31 0 23 22 22 22 22 24 0 0 0 0 0 0 0 0 0 0 0 17 0 0 0 0 0 0 23 24 0 0 0 0 0 0 0 0 0 0 0 0 0 0 0 0 0 17 
0 0 0 0 0 0 0 0 0 0 0 0 0 0 0 0 0 0 0 0 0 0 0 23 22 16 27 0 0 23 22 24 0 0 0 0 23 22 22 22 22 24 0 0 0 0 0 0 0 0 0 0 0 30 0 0 0 0 0 0 23 24 0 0 0 28 16 16 16 16 26 26 26 26 26 26 26 26 26 24 
0 0 0 0 0 0 0 0 0 0 0 0 0 0 0 0 0 0 0 0 0 0 0 23 24 0 0 0 0 23 22 24 0 0 0 0 23 22 22 22 22 24 0 0 0 0 0 0 20 26 21 0 0 0 0 0 31 21 0 0 23 24 0 0 0 0 0 0 0 0 23 22 22 22 22 22 22 22 22 24 
0 0 0 0 0 0 0 0 0 0 0 0 0 0 0 0 0 0 0 0 0 0 0 18 19 0 0 0 28 22 22 24 0 0 0 0 23 22 22 22 22 24 0 0 0 0 0 0 23 22 24 0 0 0 0 0 23 24 0 0 23 24 0 0 0 0 0 0 0 0 23 22 22 22 22 22 22 22 22 24 
0 0 0 0 0 0 0 0 0 0 0 0 0 0 0 0 0 0 0 0 0 0 0 0 0 0 0 0 0 23 22 24 0 0 0 0 23 22 22 22 22 24 0 0 0 0 0 0 23 22 24 0 0 0 0 0 23 24 0 0 18 25 16 16 16 16 27 0 0 0 23 22 22 22 22 22 22 22 22 24 
0 0 0 0 0 0 0 0 0 0 0 0 31 0 0 0 0 0 0 0 0 0 0 0 0 0 0 0 0 23 22 24 0 0 0 0 23 22 22 25 25 25 16 27 0 0 0 0 23 22 24 31 31 31 31 31 23 24 0 0 0 0 0 0 0 0 0 0 0 0 23 22 22 22 22 22 22 22 22 24 
0 0 0 0 0 0 0 0 0 0 0 0 29 0 0 0 0 0 0 0 0 0 0 0 0 0 0 0 0 23 22 24 0 31 31 31 18 25 19 0 0 0 0 0 0 0 0 0 23 22 22 26 26 26 26 26 22 24 0 0 0 0 0 0 0 0 0 0 0 0 23 22 22 22 22 22 22 22 22 24 
0 0 0 0 0 20 26 26 26 26 26 26 22 26 21 31 31 31 31 31 31 31 31 20 26 26 26 26 26 22 22 24 0 0 0 0 0 0 0 0 0 0 0 0 0 0 0 0 23 22 22 22 22 22 22 22 22 24 0 0 0 31 0 0 0 0 0 0 0 0 23 22 22 22 22 22 22 22 22 24 
0 0 0 0 0 23 22 22 22 22 22 22 22 22 22 26 26 26 26 26 26 26 26 22 22 22 22 22 22 22 22 24 0 0 0 0 0 0 0 0 0 0 0 0 0 0 0 0 23 22 22 22 22 22 22 22 22 22 26 26 26 26 26 26 26 26 26 21 31 31 23 22 22 22 22 22 22 22 22 24 
0 0 0 0 0 23 22 22 22 22 22 22 22 22 22 22 22 22 22 22 22 22 22 22 22 22 22 22 22 22 22 22 26 26 26 26 26 31 26 26 26 26 26 31 31 31 31 31 18 25 25 25 25 25 25 25 25 25 25 25 25 25 25 25 25 25 25 25 16 16 25 25 25 25 25 25 25 25 25 19 
