40
28
6 6 5 0 0 0 0 0 0 0 0 5 6 5 0 0 0 0 0 0 0 0 0 0 0 0 0 0 0 0 0 0 0 0 0 0 0 0 0 0 
6 6 5 0 0 0 0 0 0 0 0 5 5 5 0 0 0 0 0 0 0 0 0 0 0 0 0 0 0 0 0 0 0 0 0 0 0 0 0 0 
6 6 5 0 0 0 0 0 0 0 0 0 0 0 0 0 0 0 0 0 0 0 0 0 0 0 0 0 0 0 0 0 0 0 0 0 0 0 0 0 
6 6 5 0 0 0 0 0 0 0 0 0 0 0 0 0 0 0 0 0 0 0 0 0 0 0 0 0 0 0 0 0 0 0 0 0 0 0 0 0 
6 6 5 0 0 0 0 0 0 0 0 5 5 5 0 5 5 0 0 0 5 5 0 0 0 5 5 5 0 0 0 0 0 0 0 0 0 0 0 0 
6 6 5 0 0 0 0 0 0 0 0 5 6 5 8 8 8 8 8 8 8 5 0 0 0 5 6 5 0 0 0 0 0 0 0 0 0 0 0 0 
6 6 5 0 0 0 0 0 0 0 0 5 6 5 5 5 5 5 5 5 5 5 0 0 0 5 6 5 0 0 0 0 0 0 0 0 0 0 0 0 
6 6 5 0 0 8 7 5 0 0 0 5 5 5 5 5 5 5 5 5 6 5 0 0 0 5 6 5 0 0 0 0 0 0 0 0 0 0 0 0 
6 6 5 0 0 0 0 0 0 0 0 5 0 0 0 0 0 0 0 0 5 5 0 0 0 5 6 5 0 0 0 0 0 0 0 0 0 0 0 0 
6 6 5 0 0 0 0 0 0 0 0 5 0 0 0 0 0 0 0 0 0 0 0 0 0 5 6 5 0 0 0 0 0 0 0 0 0 0 0 0 
6 6 5 0 0 0 0 0 0 0 0 5 0 0 0 0 0 0 0 0 0 0 0 0 0 5 6 5 0 0 0 0 0 0 0 0 0 0 0 0 
6 6 5 0 0 0 0 0 0 0 0 0 0 0 5 5 5 0 0 0 0 0 0 0 0 5 6 6 6 6 6 6 6 6 6 6 6 6 6 5 
6 6 5 5 5 5 5 5 5 5 5 5 5 5 5 5 5 5 5 5 5 0 0 0 0 5 5 5 5 5 5 5 8 5 5 5 5 5 5 5 
6 6 6 6 6 6 6 6 6 6 6 6 6 6 6 6 6 6 6 6 5 0 0 0 0 0 0 0 0 0 0 0 0 0 0 0 0 0 0 5 
6 6 6 6 5 5 5 5 5 5 5 5 5 5 5 5 5 5 5 5 5 5 0 0 0 0 0 5 8 5 8 5 5 8 5 5 0 0 0 5 
6 6 6 6 5 0 0 0 0 0 0 0 0 0 0 0 0 0 0 0 0 0 0 0 0 0 0 0 0 0 0 0 0 0 0 0 0 0 5 5 
6 6 6 6 5 0 0 0 0 0 0 0 0 0 0 0 0 0 0 0 0 0 0 5 5 0 0 0 0 0 0 0 0 0 0 0 0 0 5 5 
5 5 5 5 5 0 0 0 0 0 0 0 0 0 0 0 0 0 0 0 0 0 0 0 0 0 0 0 0 0 0 0 0 0 0 0 0 5 5 5 
0 0 0 0 0 0 0 0 0 0 0 0 0 0 0 0 0 0 0 0 0 0 0 0 0 0 0 0 0 0 0 0 0 0 0 0 0 0 5 5 
0 0 0 0 0 0 0 0 0 0 0 0 0 0 0 0 0 0 0 0 0 0 0 0 0 0 0 0 0 0 0 0 0 0 0 0 0 0 5 5 
0 0 0 0 0 0 0 0 0 0 0 0 0 0 0 0 0 0 0 0 0 0 0 0 0 0 0 0 0 0 0 0 0 0 0 0 0 5 5 5 
0 0 0 0 0 0 0 0 0 0 0 0 0 0 0 0 0 0 0 0 0 0 0 0 0 0 0 0 0 5 5 5 0 0 0 0 0 0 5 5 
0 0 0 0 0 0 0 0 0 0 0 0 0 0 0 0 0 0 0 0 0 0 0 0 0 0 0 0 0 5 6 5 0 0 0 0 0 0 5 5 
5 5 5 5 0 0 5 5 0 0 0 0 0 0 0 0 0 0 0 0 5 0 5 5 5 0 0 0 0 5 6 5 5 5 5 5 5 5 5 5 
5 6 6 5 0 0 0 0 0 0 0 0 0 0 0 0 0 0 0 0 0 0 5 6 5 0 0 0 0 5 6 6 6 6 6 6 6 6 6 5 
5 6 6 5 0 0 0 0 0 0 0 0 0 0 0 0 0 0 0 0 0 0 5 6 5 0 0 0 0 5 6 6 6 6 6 6 6 6 6 5 
5 6 6 5 8 8 8 8 8 8 8 8 8 8 8 8 8 8 8 8 8 8 5 6 5 0 0 0 0 5 6 6 6 6 6 6 6 6 6 5 
5 6 6 5 5 5 5 5 5 5 5 5 5 5 5 5 5 5 5 5 5 5 5 6 5 0 0 0 0 5 6 6 6 6 6 6 6 6 6 5 
