20
30
9 9 9 9 9 9 9 9 9 9 9 9 9 9 9 9 9 9 9 9 
9 9 9 9 9 9 9 9 0 0 0 0 9 9 9 9 9 9 9 9 
9 9 9 9 9 9 9 9 0 0 0 0 9 9 9 9 9 9 9 9 
9 9 9 9 9 9 9 9 0 0 0 0 9 9 9 9 9 9 9 9 
9 9 9 9 9 9 9 9 0 0 0 0 9 9 9 9 9 9 9 9 
9 9 9 9 9 9 9 9 0 0 0 0 9 9 9 9 9 9 9 9 
9 9 9 9 9 9 9 9 0 0 0 0 9 9 9 9 9 9 9 9 
9 9 9 9 9 9 9 9 0 0 0 0 9 9 9 9 9 9 9 9 
9 9 9 9 9 9 9 9 0 0 0 0 9 9 9 9 9 9 9 9 
9 9 9 9 9 9 9 9 0 0 0 0 9 9 9 9 9 9 9 9 
9 9 9 9 9 9 9 9 0 0 0 0 9 9 9 9 9 9 9 9 
9 9 9 9 9 9 9 9 0 0 0 0 9 9 9 9 9 9 9 9 
9 9 9 9 9 9 9 9 0 0 0 0 9 9 9 9 9 9 9 9 
9 9 9 9 9 9 9 9 0 0 0 0 9 9 9 9 9 9 9 9 
9 9 9 9 9 9 9 9 0 0 0 0 9 9 9 9 9 9 9 9 
9 9 9 9 9 9 9 9 0 0 0 0 9 9 9 9 9 9 9 9 
9 9 9 9 9 9 9 9 0 0 0 0 0 0 0 0 0 0 0 9 
9 9 9 9 9 9 9 9 0 0 0 0 0 0 0 0 0 0 0 9 
9 9 9 9 9 9 9 9 0 0 0 0 0 0 0 0 0 0 0 9 
9 9 9 9 9 9 9 9 9 9 9 9 9 9 9 0 0 0 0 9 
9 0 0 0 0 0 0 0 0 0 0 0 0 0 0 0 0 0 0 9 
9 0 0 0 0 0 0 0 0 0 0 0 0 0 0 0 0 0 0 9 
9 0 0 0 0 0 0 0 0 0 0 0 0 0 0 0 0 0 0 9 
9 0 0 0 0 0 0 0 0 0 0 0 0 0 0 0 0 0 0 9 
9 0 0 0 0 0 9 9 9 9 9 9 9 9 9 9 9 9 9 9 
9 0 0 0 0 0 0 0 0 0 0 0 0 0 0 0 0 0 0 9 
9 0 0 0 0 0 0 0 0 0 0 0 0 0 0 0 0 0 0 9 
9 0 0 0 0 0 0 0 0 0 0 0 0 0 0 0 0 0 0 9 
9 0 0 0 0 0 0 0 0 0 0 0 0 0 0 0 0 4 0 9 
9 9 9 9 9 9 9 9 9 9 9 9 9 9 9 9 9 9 9 9 
