20
15
20 26 26 26 26 16 16 16 16 16 26 26 26 26 26 26 26 26 26 21 
23 25 25 25 24 0 0 0 0 0 23 22 22 22 22 22 22 22 22 24 
17 31 31 31 30 0 0 0 0 0 23 22 22 22 22 22 22 22 22 24 
17 0 0 0 0 0 0 0 0 0 23 22 22 22 22 22 22 22 22 24 
17 0 0 0 0 0 0 0 0 0 23 22 22 22 22 22 22 22 22 24 
17 0 0 0 31 20 26 16 27 0 23 22 22 22 22 22 22 22 22 24 
17 0 0 0 20 22 24 0 0 0 23 22 22 22 22 22 22 22 22 24 
17 0 0 0 23 22 24 0 0 0 23 22 22 22 22 22 22 22 22 24 
17 0 0 0 23 22 24 0 0 0 23 22 22 22 22 22 22 22 22 24 
17 0 0 28 22 22 24 0 31 31 18 25 25 22 25 25 25 25 25 24 
17 0 0 0 23 22 24 0 0 0 0 0 0 17 0 0 0 0 0 17 
17 0 0 0 23 22 24 0 0 0 0 0 0 30 0 0 0 0 0 17 
17 0 0 0 23 22 22 26 26 26 21 31 0 0 0 0 0 0 0 17 
17 0 0 0 23 22 22 22 22 22 22 21 0 0 0 0 0 0 4 17 
18 16 16 16 25 25 25 25 25 25 25 19 0 0 0 28 16 16 16 19 
