20
15
0 0 0 0 0 0 0 0 0 0 0 0 0 0 0 0 0 0 0 0 
0 0 0 0 0 0 0 0 0 0 0 0 0 0 0 0 0 0 0 0 
0 0 0 0 0 0 0 0 0 0 0 0 0 0 0 0 0 0 0 0 
0 0 20 16 16 16 16 16 16 16 16 16 16 16 16 16 16 21 0 0 
0 0 17 0 0 0 0 0 0 0 0 0 0 0 0 0 0 17 0 0 
0 0 17 0 0 0 0 0 0 0 0 0 0 0 0 0 0 17 0 0 
0 0 17 0 0 0 0 0 0 0 0 0 0 0 0 0 0 17 0 0 
0 0 17 0 0 0 0 0 0 0 0 0 0 0 0 0 0 17 0 0 
0 0 17 0 0 0 0 0 0 0 0 0 0 0 0 0 0 17 0 0 
0 0 17 0 0 0 0 0 0 0 0 0 0 0 0 0 0 17 0 0 
0 0 17 0 0 0 0 0 0 4 4 0 0 0 0 0 0 17 0 0 
0 0 18 16 16 16 16 16 16 16 16 16 16 16 16 16 16 19 0 0 
0 0 0 0 0 0 0 0 0 0 0 0 0 0 0 0 0 0 0 0 
0 0 0 0 0 0 0 0 0 0 0 0 0 0 0 0 0 0 0 0 
0 0 0 0 0 0 0 0 0 0 0 0 0 0 0 0 0 0 0 0 
