20
15
20 16 16 16 16 16 16 16 16 16 16 16 16 16 16 16 16 16 16 21 
17 0 0 0 0 0 0 0 0 0 0 0 0 0 0 0 0 0 0 17 
17 0 0 0 0 0 0 0 0 0 0 0 0 0 0 0 0 0 0 17 
17 0 0 0 0 0 0 0 0 0 0 0 0 0 0 0 0 0 0 17 
17 0 0 0 0 0 0 0 0 0 0 0 0 0 0 0 0 4 0 17 
17 0 0 0 31 16 16 16 16 16 16 16 16 16 16 16 16 16 16 24 
17 0 0 0 0 0 0 0 0 0 0 0 0 0 0 0 0 0 0 17 
17 0 0 0 0 0 0 0 0 0 0 0 0 0 0 0 0 0 0 17 
17 0 0 0 0 0 0 0 0 0 0 0 0 0 0 0 0 0 0 17 
17 31 31 31 0 0 0 0 0 0 0 0 0 0 0 0 0 0 0 17 
23 16 16 16 16 16 16 16 16 16 16 16 16 16 27 0 0 0 0 17 
17 0 0 0 0 0 0 0 0 0 0 0 0 0 0 0 0 0 0 17 
17 0 0 0 0 0 0 0 0 0 0 0 0 0 0 0 0 0 0 17 
17 0 0 0 0 0 0 0 0 0 0 0 0 0 0 0 0 0 0 17 
18 16 16 16 16 16 31 31 31 16 16 16 16 16 16 16 16 16 16 19 
