20
15
20 26 26 26 26 16 16 16 16 16 16 16 16 26 16 16 16 16 16 21 
23 22 22 22 24 0 0 0 0 0 0 0 31 17 0 0 0 0 0 17 
23 22 22 22 24 0 0 0 0 28 21 0 31 17 4 0 0 0 0 17 
23 22 22 22 24 0 0 0 0 31 17 0 0 23 16 16 27 0 0 17 
23 25 25 25 25 27 31 0 0 0 17 0 0 17 0 0 0 0 0 17 
17 0 0 0 0 0 0 0 0 0 17 0 0 17 0 0 0 0 0 17 
17 0 0 0 0 0 0 0 0 0 17 0 0 17 0 0 0 0 0 17 
17 0 0 0 0 0 0 0 0 0 17 31 0 23 27 0 0 0 0 17 
17 0 0 0 0 0 31 31 31 31 30 0 0 17 0 0 0 0 0 17 
23 26 26 26 26 26 16 16 31 27 0 0 0 17 0 0 0 0 0 17 
23 22 22 22 22 24 0 0 0 0 0 0 0 17 0 0 0 0 0 17 
23 22 22 22 22 24 0 0 0 0 0 0 0 17 0 0 0 2 0 17 
23 22 22 22 22 24 0 28 31 16 16 16 31 19 0 0 0 0 0 17 
23 22 22 22 22 24 0 0 0 0 0 0 0 0 0 0 0 0 0 17 
18 25 25 25 25 25 16 27 0 0 28 16 16 16 16 31 31 31 31 19 
