39
27
0 0 0 0 0 0 0 0 0 0 0 0 0 0 0 0 0 0 0 0 0 0 0 0 0 5 6 5 0 0 0 0 0 5 5 5 0 0 0 
0 0 0 0 0 0 0 0 0 0 0 0 0 0 0 0 0 0 0 0 0 0 0 0 0 5 6 5 0 5 5 8 5 0 0 0 0 0 0 
0 0 0 0 0 0 0 0 0 0 0 0 0 0 0 0 0 0 0 0 0 0 0 0 0 5 6 5 0 0 0 0 0 0 0 0 0 0 0 
0 0 0 0 0 0 0 0 0 0 0 0 0 0 0 0 0 0 0 0 0 0 0 0 0 5 6 5 0 5 0 5 0 5 5 5 5 0 0 
0 0 0 0 0 0 0 0 0 0 0 0 0 0 0 0 0 0 0 8 8 8 8 8 8 5 6 5 0 0 0 0 0 5 6 5 0 0 0 
0 0 0 0 0 5 7 5 0 0 0 0 0 0 0 0 0 0 0 0 0 0 0 0 0 5 6 5 0 0 0 0 0 5 6 5 0 0 5 
5 0 0 0 0 0 0 5 0 0 0 0 0 0 0 0 0 0 0 0 0 0 0 0 0 5 6 5 5 5 0 0 0 5 6 5 0 0 0 
5 0 0 0 0 0 0 5 5 5 5 0 0 0 0 0 0 0 0 5 5 5 5 5 0 5 6 5 0 0 0 0 0 5 6 5 5 0 0 
5 5 8 8 5 0 0 5 6 6 5 8 8 8 8 8 8 8 8 5 6 6 6 5 0 5 5 5 0 0 0 0 0 5 5 0 0 0 0 
6 6 6 6 5 0 0 5 6 6 5 5 5 5 5 5 5 5 5 5 6 6 6 5 0 0 0 0 0 0 0 5 0 0 0 0 0 0 0 
5 5 5 5 5 0 5 5 5 5 5 5 5 5 5 5 5 5 5 5 5 6 6 5 0 0 0 5 5 0 0 0 0 0 0 0 0 5 5 
0 0 0 0 0 0 0 0 0 0 0 0 0 0 0 0 0 0 0 0 0 5 6 5 5 5 8 8 8 8 8 8 8 8 8 0 8 8 8 
0 0 0 0 0 0 0 0 0 0 0 0 0 0 0 0 0 0 0 0 0 5 6 6 6 5 5 5 5 5 5 5 5 5 8 0 8 5 5 
0 0 0 0 0 5 5 5 8 5 5 5 0 5 7 7 5 0 0 0 0 5 6 6 6 5 5 5 5 5 5 5 5 5 8 0 8 5 5 
0 0 0 0 0 0 0 0 0 0 0 0 0 0 0 0 0 0 0 0 5 5 6 6 6 5 8 8 8 5 5 5 5 5 8 0 8 8 5 
0 0 0 0 0 0 0 0 0 0 0 0 0 0 0 0 0 0 0 0 0 5 6 6 6 5 0 0 0 0 0 0 0 0 0 0 0 0 5 
0 0 0 0 0 0 0 0 0 0 0 0 0 0 0 0 0 0 0 0 0 5 6 6 6 5 0 0 0 0 0 0 0 0 0 0 0 0 5 
0 0 0 0 0 0 0 0 0 0 0 0 0 0 0 0 0 0 0 0 5 5 6 6 6 5 0 0 5 5 0 0 0 5 5 5 5 5 5 
0 0 0 0 0 0 0 0 0 0 0 0 0 0 0 0 0 0 0 0 0 5 6 6 6 5 0 0 5 6 5 5 5 6 6 6 6 6 6 
0 0 0 0 0 0 0 0 0 0 0 0 0 0 0 0 0 0 0 0 0 5 6 6 6 5 0 0 5 5 5 5 5 5 5 5 5 5 5 
0 0 0 0 0 0 0 0 0 0 0 0 0 0 0 0 0 0 0 5 0 5 6 6 6 5 0 0 0 0 0 0 0 0 0 0 0 0 5 
0 0 0 0 0 0 0 0 0 0 3 0 5 5 5 0 0 0 0 0 0 5 6 6 6 5 0 0 0 0 0 0 0 0 0 0 0 0 5 
0 0 0 0 1 2 0 0 0 0 0 0 5 6 5 0 5 0 0 0 0 5 6 6 6 5 0 0 0 0 0 0 0 0 0 0 0 0 5 
0 0 0 0 0 0 0 0 0 0 5 5 5 6 5 0 0 0 0 0 0 5 6 6 6 5 5 8 5 0 0 0 0 0 0 0 3 0 5 
0 0 0 0 0 0 0 0 0 0 5 6 6 6 5 8 8 8 8 8 8 5 6 6 6 5 5 5 5 0 0 0 0 0 0 0 4 0 5 
5 5 5 5 5 5 5 5 5 5 6 6 6 6 5 5 5 5 5 5 5 5 6 6 6 5 5 5 5 5 5 5 5 5 5 5 5 5 5 
6 6 6 6 6 6 6 6 6 6 6 6 6 6 6 6 6 6 6 6 6 6 6 6 6 6 6 6 6 6 6 6 6 6 6 6 6 6 6 
