69
15
34 34 34 34 34 34 34 34 34 34 34 34 34 34 34 34 34 34 34 34 34 42 34 42 34 34 34 42 34 34 34 42 42 34 34 34 34 34 42 42 44 43 44 43 43 44 44 43 44 45 0 0 0 0 0 0 0 0 0 0 0 0 0 0 0 0 0 41 34 
34 34 42 34 34 34 42 34 34 34 42 42 34 34 34 34 34 34 42 34 34 34 34 44 44 43 44 44 43 43 44 43 44 44 43 44 43 44 43 45 1 0 0 0 1 0 0 0 0 0 0 0 0 0 0 0 0 0 0 0 0 0 0 0 0 0 0 41 42 
34 34 34 34 34 34 42 34 34 34 34 34 34 34 42 34 34 34 34 34 34 34 35 1 0 0 0 0 0 0 0 0 0 0 0 1 0 0 0 0 0 0 0 0 0 0 0 0 0 0 0 0 0 0 0 0 0 0 0 0 0 0 0 0 0 0 0 41 34 
34 44 43 43 43 44 44 43 44 43 44 43 43 44 44 43 43 43 44 43 44 43 45 0 0 0 0 0 0 0 0 0 0 0 0 0 0 0 0 0 0 0 0 0 0 0 0 0 0 0 0 0 0 0 0 0 0 0 0 0 0 0 0 0 0 0 0 41 34 
35 0 1 0 0 0 0 0 0 0 1 1 0 1 0 0 0 0 0 0 0 0 0 0 0 0 0 0 0 0 0 0 0 0 0 0 0 0 0 0 0 0 0 0 0 0 0 0 0 0 0 0 0 0 0 0 0 0 0 0 0 0 0 0 0 0 0 24 43 
35 0 0 0 0 0 0 0 0 0 0 0 0 0 0 0 0 0 0 0 0 0 0 0 0 0 0 0 0 0 0 0 0 0 0 0 0 0 0 0 0 0 0 0 0 0 0 0 0 0 0 0 0 0 0 36 0 0 0 0 0 0 0 0 0 0 0 1 0 
35 0 0 0 0 0 0 0 0 0 0 0 0 0 0 0 0 0 0 0 0 0 0 0 0 0 0 0 0 0 0 0 0 0 0 0 0 0 14 0 0 20 0 0 0 0 0 0 0 0 0 0 0 0 0 38 0 0 0 0 0 0 0 0 0 0 0 0 0 
35 0 0 0 0 0 0 0 0 0 0 0 0 0 0 0 0 0 0 0 0 0 0 0 0 0 0 0 0 0 0 0 0 0 0 0 0 29 31 32 0 0 0 0 0 0 0 0 29 32 0 0 0 0 0 38 0 0 38 0 38 0 0 0 0 0 0 0 0 
35 0 0 0 0 0 0 0 0 0 0 0 0 17 0 0 0 0 0 0 0 0 0 0 0 0 0 0 0 0 0 0 0 0 29 30 31 34 34 35 10 0 0 0 0 0 0 9 41 35 0 0 0 0 0 26 0 0 0 0 0 0 0 0 0 0 0 0 0 
35 0 0 0 0 0 0 0 0 0 0 0 0 0 10 0 0 0 0 0 0 0 0 0 0 0 0 0 0 0 0 0 17 0 41 42 34 42 34 42 30 31 30 31 31 30 31 31 34 35 0 0 0 0 0 0 0 0 0 0 0 0 0 0 0 0 0 0 0 
35 0 0 0 0 0 0 0 0 0 0 0 29 30 31 30 32 0 0 0 0 0 0 0 0 0 0 0 0 0 0 0 17 0 41 34 34 34 34 34 34 34 34 34 42 34 34 42 34 35 0 0 36 36 0 0 0 0 0 0 0 0 0 8 0 0 0 0 0 
0 0 0 0 15 16 0 0 0 0 0 0 41 34 34 34 35 0 0 0 0 0 0 0 0 0 0 0 0 0 0 0 0 0 41 34 42 34 34 34 34 34 34 34 34 34 34 34 34 35 2 3 3 3 2 2 2 3 2 3 2 3 29 30 31 30 31 31 31 
0 0 10 0 0 0 0 0 0 0 8 9 41 42 35 42 35 0 0 0 0 0 0 0 0 0 0 0 0 0 0 0 0 25 41 42 42 34 42 34 34 34 34 34 34 34 42 34 34 35 4 4 4 4 4 4 4 4 4 4 4 4 41 34 42 34 34 42 34 
34 30 31 31 30 30 31 31 30 31 31 30 34 34 34 34 35 0 0 0 0 0 10 0 0 0 0 0 0 0 0 0 0 0 41 34 34 34 34 42 34 34 42 34 34 34 34 34 34 34 31 31 30 31 31 30 31 30 31 30 30 31 34 34 34 34 34 34 34 
42 34 34 42 34 34 42 34 34 34 42 34 42 34 34 42 34 31 30 31 30 30 31 2 2 3 29 30 31 30 30 31 31 30 42 42 34 34 34 34 34 34 34 34 42 34 34 34 42 34 34 34 42 34 34 34 34 34 34 34 42 34 34 34 42 34 34 34 42 
